..........############
..........#..........#
###########..TTTTT...#
#C.T....#.S..T.H.T...#
#.##.##.#XS..T.i.T...#
#T#.....###..T...T...#
#....#H...#..TTTTT...#
#..H......#........h.#
#########T########TT##
#..S.T.S.h#...M.....#.
#..T.S.T..#.S....S..#.
#.#########...H..M..#.
#.STT.TS..T.........#.
#..TTST..h#.S....S..#.
########..T....M....#.
.......##############.
