###############
#...H.........#
#.###..M......#
#.#XS.........#
#.###..M..SS###
#.........Si..#
#.........#...#
#.........#..C#
###############

