..........############
..........#..........#
###########..TTTTT...#
#C.F....#.S..T.H.T...#
#.##.##.#XS..T.i.T...#
#F#.....###..T...T...#
#....#H...#..TTTTT...#
#..H......#........h.#
#########T########TT##
#h.S.T.S.h#...M.....#.
#..T.S.T..#.S....S..#.
#.#########...H..M..#.
#.STT.TS..T.........#.
#..TTST..h#.S....S..#.
########..T....M....#.
.......##############.
\