SSSSSSSSSSSSSSSSSSSS
#C............S....S 
#.####.###.##.S.SS.S
#.#...T##..#..S.S..S
#T#M#.##..##.SS.S.#S
#T#...###..#....S...
#.M##..#.T###SSSSSS.
#M.##..h#....###i#S.
#..##.###.######.#S.
#T#...H...##h....#S.
#.M.#####.######.#S.
#T#...H.......##T...
#.###############...
#X.TMMMMMMMT....T..#
####################
\