################
#...T........###
#...#......M.###
#C..T..H#..M..X#
#...#........###
#...T........###
################
