###############
#C...........h#
######T###.####
#I#.M..##..#.h#
#.#....#..##.##
#.#....##.#...#
#.#T##T#.T#.#.#
#.#....##.#..H#
#.#....##.###.#
#.T.M..T.....h#
#T#T#####.#####
#.....H.......#
#T#...###T#####
#H..M.....T..X#
###############
\







C->StartingLocation
#->Walls
.->walkingspaces

T=TimingTrap
M = Monster
B = Blockade

h = heal powerup



If you fall off to the right you will be returned to the begining

More to be added?
