####################
#CF..........I#....# 
#FSSSS.SSS.SS.S.SS.#
#.#...T##..#..#.#..#
#.#M#.##..##.#S.S.S#
#.#...SSS..S....S...
#.#SS..S.TSSSS.SSSS.
#M#SS..hS.###S.#s##.
#.#SS.SSS.######.#S.
#.#.......##h....#S.
#.M.#####.######.SS.
#T#...H.......S#T...
#.#######T###.#.##..
#X.T..........##...#
####################
\