###############
#CF.s.h.H....H#
#.F.....H..h..#
###.#...H.....#
#T.T....H....h#
#.#.#.#########
#.#.#...TT.TT.#
#TSSSSSSSSSSST#
#.............#
#####h##.......
#########T#####
S.TTT.........#
#.###S###S###.#
#XT.......SSS.#
#########.....#
\







C->StartingLocation
#->Walls
T=TimingTrap

h = heal powerup

.->walkingspaces

If you fall off to the right you will be returned to the begining

More to be added?
