###############
#......C......#
#............M#
#.............#
#M............#
#....#####....#
#......s......#
#.M.........M.#
#H...M...M...H#
#TTTTTTTTTTTTT#
#.............#
#....H...H....#
#..M..SSS..M..#
#M....TXT....M#
###############