################
#...#........###
#...#......M.###
#C..T..M#..M..X#
#...#........###
#...#........###
################
