####################
#C...........i#....# 
#.SSSS.SSS.SS.S.SS.#
#.#...T##..#..#.#..#
#.#M#.##..##.#S.S.S#
#T#...SSS..S....S...
#T#SS..S.TSSSS.SSSS.
#M.SS..hS.###S.#s##.
#..SS.SSS...####.#S.
#T#.......##h....#S.
#.#M#####.######.SS.
#.#...H.......S#T...
#.#######T###.#.##..
#X.T..........##...#
####################
\