################
#...T........###
#...#......M.###
#C..T..H#..M..X#
#...#....H...###
#...T........###
################
\