################
#............###
#............###
#C.....##..M..X#
#............###
#............###
################
