###############
#C.....s.....h#
#.............#
#.#.#....X....#
#..T..........#
#.#.#..###....#
#.......T.....#
#.............#
#.............#
#.#...h.......#
#...#####.#####
#.#...........#
#.###.###T###.#
#..T..........#
###############
\







C->StartingLocation
#->Walls
T=TimingTrap

h = heal powerup

.->walkingspaces

If you fall off to the right you will be returned to the begining

More to be added?
