SSSSSSSSSSSSSSSSSSSS
#C............S....S 
#.####.###.##.S.SS.S
#.#...T##..#..S.S..S
#T#M#.##..##.SS.S.#S
#.#...###..#....S...
#.###..#.T###SSSSSS.
#M###..h#....###i#S.
#.###.###.######.#S.
#S#...H...##h....#S.
#.M.#####.######.#S.
#S#...H.......##T...
#.###############...
#X.TMMMMMMM.....T..#
####################
\