...................
.....SSSSSSS........
....S.......S.......
...S..SSSSS..S......
...S.S.....S.S......
...S.S.SSS.S.S......
...S.S..CS.S.S......
...S..SSTS.S.S......
....S......S.S......
.....SSSTSSSXS......
..................
\

Spiral Level of Only spikes

