###############
#C.....s.....h#
#.............#
###.#.........#
#T.T..........#
#.#.#.#########
#.#.#...T.....#
#TSSSSSSSSSSST#
#.............#
#####h##.......
#########T#####
#TTTT.........#
#T###S###S###.#
#XT.......SSS.#
#########.....#
\







C->StartingLocation
#->Walls
T=TimingTrap

h = heal powerup

.->walkingspaces

If you fall off to the right you will be returned to the begining

More to be added?
