###############
#CF.sTh.H....H#
#.#..T..#..h..#
#T#T#.........#
#T..T...H....h#
#.#.#F#########
#.#hT...TT.TT.#
#TS####SSSSSST#
#.............#
#####h##......#
#########T#####
S.TTT.........#
#.###S###S###.#
#XT.......SSS.#
#########.....#
........#######
\







C->StartingLocation
#->Walls
T=TimingTrap

h = heal powerup

.->walkingspaces

If you fall off to the right you will be returned to the begining

More to be added?
