################
#...F........###
#...#......M.###
#C..T..H#..M..X#
#...#....H...###
#...F........###
################
\