###############
#......C......#
#............M#
#.............#
#M............#
#....#####....#
#.............#
#.M.M.M.M.M.M.#
#.............#
#.............#
#.............#
#..M.....M....#
#.....SSS.....#
#HH...TXT...HH#
###############