############
#C..#.TTT.S#
#...T.##S.##
#####.#....#
#...S.#..# #
#.S...#..#T#
#T#####..# #
#..S....h#T#
#S...S####X#
############
\


2nd maze
C->StartingLocation
#->Walls
T=TimingTrap
X = Exit

h = heal powerup