SSSSSSSSSSSSSSSSSSSS
#C............S....S 
#.####.###.##.S.SS.S
#.#...T##..#..S.S..S
#.#M#.##..##.SS.S.#S
#.#...###..#....S...
#.###..#.T###SSSSSS.
#M###..h#....###i#S.
#.###.###.######.#S.
#.#...H...##h....#S.
#.M.#####.######.#S.
#.#...H.......##T...
#.###############...
#X.TMMMMMMM........#
####################
\