###############
#.....FC......#
#............M#
#.............#
#M............#
#....#####....#
#.....FsF.....#
#.M...FFF...M.#
#H...M...M...H#
#TTTTTTTTTTTTT#
#.............#
#....H...H....#
#..M..SSS..M..#
#M....TXT....M#
###############
\